*.....*.
*.....*.
........
*......*
********
**.**.**
********
*......*
